000000000000000000000000000000000000000000000000000000000000000000000000000000000000000000000000000000000000000000000000000000000000000
0                                                    1                                1                                               0
0      x 11111111                                    1                                1                                               0
0                                                    1                                1                                               0
0                           k                        1                                1                                               0
0                                                    1                                1                                               0
0                                                    1                                1                                               0
0                                                    1                                1                                               0
0                                      e             1                                1                                               0
0                                                    1                                1                                               0
0                                                    1                                1                                               0
0                                                    1                               21                                               0
0                                                    1                             1111                 11111111111111111             0
01111111111111111111111                              1                                                  1       1       1             0
0                    21                              12                                                 1       1       1             0
0                     1                              111111111111111111                                 1       1       1             0
0                     1                                               1                                 1       1       1             0
0                     1                                               1                                 1       1       11111111      0
0    111111111111     1                                               1                                 1       1                     0
0    1                1                                               1                                 1       1                     0
0    1                1                                               1                                 1                             0
0    1                1                                               1                                 1                             0
0    1                1                                               1                                 1                             0
0    111111111111111111                                               1                                 1111111111111111111111111111110
0                                                                     1                                                               0
0                                                                                                                                     0
0                                                                                                                                     0
0                                                                                                                                     0
0                                                                                                                                     0
0                                                                                                            11111111111111111        0
0                                                                                                            1               1        0
011111111111111111111      11111111111111111111111111                                                        1               1        0
0                   1      1                        1                                                        1                        0
0                   1      1                        1                                                        1                        0
0                   1      1                        1                  111111111111111111111                 11111111111111111111111110
0                   1      1                        1                  1                                                              0
0                  21      12                       1                  1                                                              0
0       1111111111111      11111111111              1                  1                                                              0
0                                                   1                  1                                                              0
0                                                   1                  1           11111111                                           0
0                                                   1                  1           1      1                                           0
0                                                   1                  1           1      1                    11111111111111         0
01111111111111111111111111111111111111111111111111111                  12          1      1                    1            1         0
0                                                                      1111111111111      1                    1            1         0
0                                                                                         1                    1            111       0
0                                                                                         1                    1                      0
0                                                                                         1                    1                      0
0                                                                                         1                    1                      0
0                                                                                         1                    1                      0
0                                                                                         1                    1                      0
0                                                                                         1                    1                      0
0                                                                                         1                    1                      0
000000000000000000000000000000000000000000000000000000000000000000000000000000000000000000000000000000000000000000000000000000000000000