000000000000000000000000000000000000000000000000000000000000000000000000000000000000000000000000000000000000000000000000000000000000000
0                                                    1                                1                                               0
0      x 11111111                                    1                                1                                               0
0                                                    1                                1                                               0
0                                                    1                                1                                               0
0                    3                               1                       8        1                    5                          0
0                                                    1                                1                                     8         0
0                                                    1       7    4                   1                                               0
0                                  3                 1                                1                                               0
0                       3                            1                                1                                               0
0                                                    1                                1                                               0
0                                                    1                               21                                               0
0                                                    1                      4      1111                 11111111111111111             0
01111111111111111111111                              1                                                  1       1       1             0
0                    21               3              12                                                 1       1       1             0
0                     1                              111111111111111111                                 1       1       1             0
0                     1                                               1                                 1       1       1             0
0                     1                                               1                                 1       1  8    11111111      0
0    111111111111     1      7                     3                  1                                 1       1                     0
0    1                1                                               1                                 1       1     6               0
0    1                1                                               1                                 1                             0
0    1           4    1                                               1                                 1                             0
0    1                1         3                                     1               7        8        1                             0
0    111111111111111111                                               1                                 1111111111111111111111111111110
0                                                                     1                                                               0
0                                                                                                                        6            0
0             4                                                3                     4                                                0
0                      8                        3                                                                                     0
0                                                                                                                                     0
0                                                                             6                              11111111111111111        0
0                                                                                                            1               1        0
011111111111111111111      11111111111111111111111111                                                        1               1        0
0                   1      1                        1                                                        1     4                  0
0                   1      1                        1                                                        1                        0
0                   1      1                8       1                  111111111111111111111                 11111111111111111111111110
0                   1      1                        1         4        1                                                              0
0                  21      12                       1                  1                                                              0
0       1111111111111      11111111111      4       1                  1                                                              0
0                                                   1                  1     4                                                        0
0                                                   1                  1           11111111       7                                   0
0                                                   1                  1           1      1                                           0
0                                                   1                  1           1      1                    11111111111111         0
01111111111111111111111111111111111111111111111111111                  12          1      1                    1            1         0
0                                                                      1111111111111      1                    1            1         0
0                                                                                         1                    1            111       0
0                                                                                         1                    1        5             0
0                 5                              5                                        1                    1                      0
0                                                                   8                     1                    1                      0
0                                                                                      8  1                 5  1                      0
0                             5                                                           1                    1                      0
0                                                                           5             1                    1                      0
0                                                                                         1                    1                      0
000000000000000000000000000000000000000000000000000000000000000000000000000000000000000000000000000000000000000000000000000000000000000